doctor,0,1,2,3,4,5,Всего
Dr. Alex,0,0,1,1,1,0,3
Dr. Anna,10,6,3,10,9,18,56
Dr. Ben,7,3,2,6,4,9,31
Dr. Bob,7,3,3,9,5,13,40
Dr. Charlie,0,0,0,0,0,4,4
Dr. Quinn,0,0,0,0,0,1,1
Dr. Rudy,1,2,0,0,0,1,4
Lab,10,6,4,10,9,18,57
Nurse Corey,7,4,1,5,2,6,25
Nurse Jesse,3,2,3,5,7,12,32
Pharmacy,9,4,3,9,8,12,45
Team 1,2,3,2,5,6,5,23
Team 2,7,3,1,5,3,9,28
Всего,63,36,23,65,54,108,349
