doctor,0,1,2,3,4,Всего
Dr. Alex,2,0,0,0,2,4
Dr. Anna,7,4,50,3,5,69
Dr. Ben,3,3,28,1,1,36
Dr. Bob,5,3,35,3,4,50
Dr. Charlie,1,0,0,0,3,4
Dr. Quinn,1,0,0,1,0,2
Dr. Rudy,3,0,0,2,0,5
Lab,7,4,51,3,5,70
Nurse Corey,4,1,24,1,2,32
Nurse Jesse,3,3,27,2,3,38
Pharmacy,0,4,51,0,0,55
Team 1,2,0,27,0,1,30
Team 2,5,0,24,0,4,33
Всего,43,22,317,16,30,428
